#####
#...#
#...#
#.p.#
#...################
#..................#
#..................#
#..................#
#..................#
####################