#####    ###############
#...#    #.............#
#...#    #....##########
#.p.#    #....#
#...######....######
#..................#
#..................#
#..................#
#..................#
#############.######
#            .
#            .
#            .
#.............

