#########
#....p..#
#.......#
#...p...#
#........#
#....p.p..#
#........#
#########
#################