###################################
#.................................#
#...p.............................#
#.................................#
#####################.............#
                    #.............#
                    #.............#
                    #.............#
                    #.............#
                    #.............#
                    #.............#
                                 