-----------------------------------------------------------------------------------------------
-----------------------------------------------------------------------------------------------
-----------------------------------------------------------------------------------------------
---------------------------------#######-------------------------------------------------------
---------------------------------#.....#------------------------------------------------------
---------------------------------#.....#-------------------------------------------------------
---------------------------------#.....#-------------------------------------------------------
---------------------------------#.....#-------------------------------------------------------
---------------------------------#.....#-------------------------------------------------------
---------------------------------#.....######################----------------------------------
---------------------------------#...............t..........#----------------------------------
---------------------------------#...............t..........#----------------------------------
---------------------------------#......h........t..........#----------------------------------
---------------------------------#...............t..........#----------------------------------
---------------------------------#...............t..........#----------------------------------
---------------------------------#...............t..........#----------------------------------
---------------------------------######################dd####----------------------------------
---------------------------------------------------#........#----------------------------------
---------------------------------------------------#........#----------------------------------
---------------------------------------------------#........#----------------------------------
---------------------------------------------------#........#----------------------------------
---------------------------------------------------#........#----------------------------------
---------------------------------------------------#....t...#----------------------------------
--------------------------------####################........#----------------------------------
--------------------------------#..................#........#----------------------------------
--------------------------------#..t...............#........#----------------------------------
--------------------------------#......................e....#----------------------------------
--------------------------------#...........................#----------------------------------
--------------------------------#.....t............e........#----------------------------------
--------------------------------#...........................#----------------------------------
--------------------------------#......######################----------------------------------
--------------------------------#......#-------------------------------------------------------
--------------------------------#......#-------------------------------------------------------
--------------------------------#......#-------------------------------------------------------
--------------------------------#......#-------------------------------------------------------
--------------------------------#......#-------------------------------------------------------
--------------------------------#......#-------------------------------------------------------
--------------------------------#......#-------------------------------------------------------
--------------------------------#......#-------------------------------------------------------
--------------------------------#......#-------------------------------------------------------
--------------------------------#......#-------------------------------------------------------
--------------------------------#......#-------------------------------------------------------
--------------------------------#......#-------------------------------------------------------
---------------------------########..########--------------------------------------------------
---------------------------#................#--------------------------------------------------
---------------------------#....t...........#--------------------------------------------------
---------------------------#................#--------------------------------------------------
---------------------------#..............k.#--------------------------------------------------
---------------------------#........#########--------------------------------------------------
---------------------------#................#--------------------------------------------------
---------------------------#................#--------------------------------------------------
---------------------------#................#--------------------------------------------------
---------------------------#................#--------------------------------------------------
---------------------------#................#--------------------------------------------------
---------------------------#................#--------------------------------------------------
---------------------------#aaaaaaaaaaaaaaaa#--------------------------------------------------
---------------------------#................#--------------------------------------------------
---------------------------#................#--------------------------------------------------
---------------------------#................#--------------------------------------------------
---------------------------#................#--------------------------------------------------
---------------------------#................#--------------------------------------------------
---------------------------#................#--------------------------------------------------
---------------------------#................#--------------------------------------------------
---------------------------#................#--------------------------------------------------
---------------------------#....e........e..#--------------------------------------------------
---------------------------#................#--------------------------------------------------
---------------------------#................#--------------------------------------------------
---------------------------#................#--------------------------------------------------
---------------------------#................#--------------------------------------------------
---------------------------########..########--------------------------------------------------
---------------------------#................#--------------------------------------------------
---------------------------#................#--------------------------------------------------
---------------------------#................#--------------------------------------------------
---------------------------#................#--------------------------------------------------
---------------------------#................#--------------------------------------------------
---------------------------#................#--------------------------------------------------
---------------------------#................#--------------------------------------------------
---------------------------#................#--------------------------------------------------
---------------------------#................#--------------------------------------------------
---------------------------#................#--------------------------------------------------
---------------------------#................#--------------------------------------------------
---------------------------#........p.......#--------------------------------------------------
---------------------------#................#--------------------------------------------------
---------------------------#................#--------------------------------------------------
---------------------------#................#--------------------------------------------------
---------------------------##################--------------------------------------------------

a = avgrund, man ska dasha över
e = enemy
k = key
t = tillfallig vagg (haha noPe it's da turtlemaster)
h = stalle dar arrows hittar
d = låst dörr
1 = vägg uPP
2 = vägg höger
3 = vägg ner
4 = vägg vänster
