############################
#..........................#
#..........................#
#..........................#
#..........................#
#..............p...........#
#..........................#
#..........................#
#..........................#
#..........................#
#..........................#
############################
