############################
#..........................#
#..........................#
#..........................#
#..........................#
#..............p...........#
#..........................#
#..........................#
#..........................#
#..........................#
#..........................#
############...#############
           #...#
           #...############################################################
           #...............................................................
           #...............................................................
           #...............................................................
           ################################################################