############################################################
#..........................................................#
#..........................................................#
#..........................................................#
#..........................................................#
#..........................................................#
#.....p..........xxx.......................................#
#..........................................................#
#..........................................................#
#.............xxxx.........................................#
#..........................................................#
#..........................................................#
#..........................................................#
#..........................................................#
#..........................................................#
############################......##########################
#...........................#....#.........................#
#...........................#....#.........................#
#...........................#....#.........................#
#...........................#....#.........................#
#........x..................#....#.........................#
#...........................#....#.........................#
#...........................#....#.........................#
#...........................#....#.........................#
#############################....###########################
#............................#..#..........................#
#............................#..#..........................#
#............................#..#..........................#
#............................#..#..........................#
#............................#..#..........................#
#............................#..#..........................#
#............................#..#..........................#
#............................#..#..........................#
#.........#......................................#.........#
#.........#......................................#.........#
#.........#......................................#.........#
#.........#......................................#.........#
#.........#......................................#.........#
#.........#......................................#.........#
############################################################
