#########
#.......#
#.......#
#...p...#
#########