#######
#.....#
#..p..#
#.....#
#######
