-----------------------------------------------------------------------------------------------
-----------------------------------------------------------------------------------------------
-----------------------------------------------------------------------------------------------
---------------------------------##ggg##-------------------------------------------------------
---------------------------------#.....#-------------------------------------------------------
---------------------------------#.....#-------------------------------------------------------
---------------------------------#.....#-------------------------------------------------------
---------------------------------#.....#-------------------------------------------------------
---------------------------------#.....#-------------------------------------------------------
---------------------------------#.....######################----------------------------------
---------------------------------#...............t..........#----------------------------------
---------------------------------#...............t..........#----------------------------------
---------------------------------#......h........t..........#----------------------------------
---------------------------------#...............t..........#----------------------------------
---------------------------------#...............t..........#----------------------------------
---------------------------------#...............t..........#----------------------------------
---------------------------------######################dd####----------------------------------
---------------------------------------------------#........#----------------------------------
---------------------------------------------------#........#----------------------------------
---------------------------------------------------#........#----------------------------------
---------------------------------------------------#........#----------------------------------
---------------------------------------------------#........#----------------------------------
---------------------------------------------------#....t...#----------------------------------
--------------------------------####################........#----------------------------------
--------------------------------#..................#........#----------------------------------
--------------------------------#..t...............#........#----------------------------------
--------------------------------#......................e....#----------------------------------
--------------------------------#...........................#----------------------------------
--------------------------------#.....t............e........#----------------------------------
--------------------------------#...........................#----------------------------------
--------------------------------#......######################----------------------------------
--------------------------------#......#-------------------------------------------------------
--------------------------------#......#-------------------------------------------------------
--------------------------------#......#-------------------------------------------------------
--------------------------------#......#-------------------------------------------------------
--------------------------------#......#-------------------------------------------------------
--------------------------------#......#-------------------------------------------------------
--------------------------------#......#-------------------------------------------------------
--------------------------------#......#-------------------------------------------------------
--------------------------------#......#-------------------------------------------------------
--------------------------------#......#-------------------------------------------------------
--------------------------------#......#-------------------------------------------------------
--------------------------------#......#-------------------------------------------------------
--------------------------- 1111###..###1111 --------------------------------------------------
---------------------------6................7--------------------------------------------------
---------------------------6....t...........7--------------------------------------------------
---------------------------6................7--------------------------------------------------
---------------------------6..............k.7--------------------------------------------------
---------------------------6........########7--------------------------------------------------
---------------------------6................7--------------------------------------------------
---------------------------6................7--------------------------------------------------
---------------------------6................7--------------------------------------------------
---------------------------6................7--------------------------------------------------
---------------------------6................7--------------------------------------------------
---------------------------6................7--------------------------------------------------
---------------------------6aaaaaaaaaaaaaaaa7--------------------------------------------------
---------------------------6................7--------------------------------------------------
---------------------------6................7--------------------------------------------------
---------------------------6................7--------------------------------------------------
---------------------------6................7--------------------------------------------------
---------------------------6................7--------------------------------------------------
---------------------------6................7--------------------------------------------------
---------------------------6................7--------------------------------------------------
---------------------------6................7--------------------------------------------------
---------------------------6....e........e..7--------------------------------------------------
---------------------------6................7--------------------------------------------------
---------------------------6................7--------------------------------------------------
---------------------------6................7--------------------------------------------------
---------------------------6................7--------------------------------------------------
---------------------------#######..########7-------------------------------------------------
---------------------------6................7--------------------------------------------------
---------------------------6................7--------------------------------------------------
---------------------------6................7--------------------------------------------------
---------------------------6................7--------------------------------------------------
---------------------------6................7--------------------------------------------------
---------------------------6................7--------------------------------------------------
---------------------------6................7--------------------------------------------------
---------------------------6................7--------------------------------------------------
---------------------------6................7--------------------------------------------------
---------------------------6................7--------------------------------------------------
---------------------------6................7--------------------------------------------------
---------------------------6........p.......7--------------------------------------------------
---------------------------6................7--------------------------------------------------
---------------------------6................7--------------------------------------------------
---------------------------6................7--------------------------------------------------
---------------------------488888888888888885--------------------------------------------------
C (Write comments below C)

a = avgrund, man ska dasha över
e = enemy
k = key
t = tillfallig vagg (haha noPe it's da turtlemaster)
h = stalle dar arrows hittar
d = låst dörr
g = Progress to next level

Walls of coolness:
1 = UP
2 = UPLeft
3 = UPRight
4 = DownLeft
5 = DownRight
6 = Left
7 = Right
8 = Down
# = Full